/45/45/45/45/45/45/45/45/45/45/45/45/45/45/45/45/45/45/45/45/45/45/45/45/45/45/45/45/45/45/45/45/
/45/45/45/45/45/45/45/45/45/45/45/45/45/45/45/45/45/45/45/45/45/45/45/45/45/45/45/45/45/45/45/45/
/45/45/14/26/26/26/26/28/26/26/26/26/26/26/26/26/26/26/26/26/26/26/26/26/26/26/26/26/26/15/45/45/
/45/45/21/ 9/ 8/ 8/ 8/21/ 8/ 8/ 8/ 8/ 8/ 8/ 8/ 8/ 8/ 8/ 8/ 8/ 8/ 8/ 8/ 8/ 8/ 8/ 8/ 8/11/21/45/45/
/45/45/21/ 5/ 4/ 4/ 4/21/ 4/ 4/ 4/ 4/ 4/ 4/ 4/ 4/ 4/ 4/ 4/ 4/ 4/ 4/ 4/ 4/ 4/ 4/ 4/ 4/ 7/21/45/45/
/45/45/21/12/12/12/12/21/12/12/12/12/12/12/12/12/12/12/12/12/12/12/12/12/12/12/12/12/12/21/45/45/
/45/45/21/12/12/12/12/21/12/12/12/12/12/12/12/12/12/12/12/12/12/12/12/12/12/12/12/12/12/21/45/45/
/45/45/21/12/12/12/12/21/12/12/12/12/12/12/12/12/12/12/12/12/12/12/12/12/12/12/12/12/12/21/45/45/
/45/45/21/12/12/12/12/21/12/12/12/12/12/12/12/12/12/12/12/12/12/12/12/12/12/12/12/12/12/21/45/45/
/45/45/21/12/12/12/12/21/12/12/14/26/26/26/26/26/26/26/26/26/15/12/12/12/12/12/12/12/12/21/45/45/
/45/45/21/12/12/12/12/21/12/12/21/ 9/ 8/ 8/ 8/ 8/ 8/ 8/ 8/11/21/12/12/12/12/12/12/12/12/21/45/45/
/45/45/24/18/12/12/16/23/12/12/21/ 5/ 4/ 4/ 4/ 4/ 4/ 4/ 4/ 7/21/12/12/12/12/12/12/12/12/21/45/45/
/45/45/21/11/12/12/ 9/11/12/12/21/41/41/41/41/41/41/41/41/41/21/12/12/12/12/12/12/12/12/21/45/45/
/45/45/21/ 7/12/12/ 5/ 7/12/12/21/41/29/41/29/41/29/41/32/33/21/12/12/12/12/12/12/12/12/21/45/45/
/45/45/21/12/12/12/12/12/12/12/21/41/30/41/30/41/30/41/40/41/21/12/12/12/12/12/12/12/12/21/45/45/
/45/45/21/12/12/12/12/12/12/12/21/41/30/41/30/41/30/41/40/41/21/12/12/12/12/12/12/12/12/21/45/45/
/45/45/21/12/12/12/12/12/12/12/21/41/30/41/30/41/30/41/40/41/21/12/12/14/26/26/26/26/26/25/45/45/
/45/45/21/12/12/12/12/12/12/12/21/41/31/41/31/41/31/41/48/49/21/12/12/21/ 9/ 8/ 8/ 8/11/21/45/45/
/45/45/21/12/12/12/12/12/12/12/21/41/41/41/41/41/41/41/41/41/21/12/12/21/ 5/ 4/ 4/ 4/ 7/21/45/45/
/45/45/21/12/12/12/12/12/12/12/22/26/18/41/41/16/26/26/26/26/23/12/12/21/12/12/12/12/12/21/45/45/
/45/45/21/12/12/12/12/12/12/12/ 9/ 8/11/41/41/ 9/ 8/ 8/ 8/ 8/11/12/12/20/12/12/12/12/12/21/45/45/
/45/45/21/12/12/12/12/12/12/12/ 5/ 4/ 7/41/41/ 5/ 4/ 4/ 4/ 4/ 7/12/12/10/12/12/12/12/12/21/45/45/
/45/45/21/12/12/12/12/12/12/12/12/12/12/12/12/12/12/12/12/12/12/12/12/ 6/12/12/12/12/12/21/45/45/
/45/45/21/12/12/12/12/12/12/12/12/12/12/12/12/12/12/12/12/12/12/12/12/12/12/12/12/12/12/21/45/45/
/45/45/21/12/12/12/12/12/12/12/12/12/12/12/12/12/12/12/12/12/12/12/12/12/12/12/12/12/12/21/45/45/
/45/45/22/26/26/26/26/26/26/26/26/26/26/26/26/26/26/26/26/26/26/26/26/26/26/26/26/26/26/23/45/45/
/45/45/ 9/ 8/ 8/ 8/ 8/ 8/ 8/ 8/ 8/ 8/ 8/ 8/ 8/ 8/ 8/ 8/ 8/ 8/ 8/ 8/ 8/ 8/ 8/ 8/ 8/ 8/ 8/11/45/45/
/45/45/ 5/ 4/ 4/ 4/ 4/ 4/ 4/ 4/ 4/ 4/ 4/ 4/ 4/ 4/ 4/ 4/ 4/ 4/ 4/ 4/ 4/ 4/ 4/ 4/ 4/ 4/ 4/ 7/45/45/
/45/45/45/45/45/45/45/45/45/45/45/45/45/45/45/45/45/45/45/45/45/45/45/45/45/45/45/45/45/45/45/45/
/45/45/45/45/45/45/45/45/45/45/45/45/45/45/45/45/45/45/45/45/45/45/45/45/45/45/45/45/45/45/45/45/
*