/3/3/3/3/3/3/3/3/3/3/3/3/3/3/3/3/3/3/3/3/3/3/3/3/3/3/
/4/5/5/5/5/5/5/5/5/6/5/5/5/5/5/5/6/5/5/5/5/5/5/5/5/7/
/8/3/3/3/3/3/3/3/3/8/3/3/3/3/3/3/8/3/3/3/3/3/3/3/3/8/
/8/2/2/2/2/7/2/2/2/8/2/2/2/2/2/2/8/2/2/2/2/2/2/2/2/8/
/8/2/2/2/2/2/2/2/2/8/2/2/2/2/2/2/8/2/2/2/2/2/2/2/2/8/
/8/2/2/2/2/2/2/2/2/8/2/2/2/2/2/2/8/2/2/2/2/2/2/2/2/8/
/8/2/2/2/2/2/2/2/2/2/2/2/2/2/2/2/2/2/2/2/2/2/2/2/2/8/
/8/2/2/2/2/2/2/2/2/2/2/2/2/2/2/2/2/2/2/2/2/2/2/2/2/8/
/8/2/2/2/2/2/2/2/2/8/2/2/2/2/2/2/8/2/2/2/2/2/2/2/2/8/
/8/2/2/2/2/2/2/2/2/8/2/2/2/2/2/2/8/2/2/2/2/2/2/2/2/8/
/8/2/2/2/2/2/2/2/2/8/2/2/2/2/2/2/8/2/2/2/2/2/2/2/2/8/
/8/5/5/5/5/5/5/5/5/5/2/2/2/2/2/2/9/5/5/5/5/5/5/5/5/8/
/8/3/3/3/3/3/3/3/3/3/2/2/2/2/2/2/3/3/3/3/3/3/3/3/3/8/
/8/2/2/2/2/2/2/2/2/2/2/2/2/2/2/2/2/2/2/2/2/2/2/2/2/8/
/8/2/2/2/2/2/2/2/2/2/2/2/2/2/2/2/2/2/2/2/2/2/2/2/2/8/
/8/2/2/2/2/2/2/2/2/2/2/2/2/2/2/2/2/2/2/2/2/2/2/2/2/8/
/8/2/2/2/2/2/2/2/2/2/2/2/2/2/2/2/2/2/2/2/2/2/2/2/2/8/
/8/5/5/5/5/5/5/5/5/5/5/5/5/5/5/5/5/5/5/5/5/5/5/5/5/8/
/3/3/3/3/3/3/3/3/3/3/3/3/3/3/3/3/3/3/3/3/3/3/3/3/3/3/
*