33333333333333333333333333
45555555565555556555555557
83333333383333338333333338
82222722282222228222222228
82222222282222228222222228
82222222282222228222222228
82222222222222222222222228
82222222222222222222222228
82222222282222228222222228
82222222282222228222222228
82222222282222228222222228
85555555552222229555555558
83333333332222223333333338
82222222222222222222222228
82222222222222222222222228
82222222222222222222222228
82222222222222222222222228
85555555555555555555555558
33333333333333333333333333
00000000000000000000000000